Abendessen=dinner (n)
aber=but
abfahren=depart
Adresse=address (f)
alein=alone
alles=everything
alt=old
Anderes=other (n)
anfangen=begin
ankommen=arrive
Annas=pineapple
antwort=answer
Apfel=apple
Apfelsaft=apple juice
Aprikose=apricot
arbeit=work
Arzt=doctor
Auge=eye
Ausblick=view
Auto=car
Backerei=bakery
Backpflaume=prune
Birne=pear
Bromberre=blackberry
Brot=bread
Abend=evening (m)
Abendessen=dinner or supper (n)
aber=but
Abfahrt=departure (f)
abreisen=depart, leave
abwesend=absent
acht=eight
Adresse=address (f)
Alkohol=alcohol {m)
alle=all
allein=alone
alles=everything
als=as(when)
als=than
alt=old
Alter=age (n) 
Ameise=ant (f) 
an=at(place)
anderer=other
Anfang=beginning (m) 
Anfrage=demand (f) 
angenehm=pleasant
Angst=fear (f) 
anhalten=stop (verb)
ankommen=arrive
Ankunft=arrival (f) 
annehmen=accept
Antwort=answer (f) 
Anzug=suit (m) 
Apfel=apple (m) 
Appetit=appetite (m) 
Aprikose=apricot (f) 
April=April (m) 
Arbeit=work(noun) (f) 
arbeiten=work(verb)
arm=poor
Arm=arm (m) 
Armbanduhr=clock,watch (f) 
Armee=army (f) 
Art=kind (f) 
Art=manner,way (f) 
Arzt=doctor (f) 
auch=also, too
auch=too
auf=on
auf Wiedersehen=good-bye
auf=up
Aufgabe=task (f) 
Auge=eye (n) 
August=August (m) 
Ausgang=exit (m) 
ausgezeichnet=excellent
ausser=except
äusserst=extreme
auswendig=by heart
Auto fahren=drive
Auto=automobile (n) 
Baby=baby (m) (n) 
backen=bake
Bäcker=baker (m) 
Bäckerei=bakery (f) 
Bad=bath (n) 
Badezimmer=bathroom (n) 
Bahnhof=station (m) 
bald=soon
Balkon=balcony (m) 
Ball=ball (m) 
Banane=banana (f) 
Bank=bank (f) 
Banknote=bank note (f) 
Bar=bar (f) 
Bär=bear (m) 
Bart=beard (m) 
Bauernhof=farm (m) 
Baum=tree (m) 
bedeuten=signify
beenden=finish, end
beginnen=begin
beginnen=start
beide=both
Bein=leg (n) 
Beispiel=example (f) 
bekommen=get,receive
Benzin=gasoline (n) 
bereit=ready
Berg=mountain (m) 
berühren=touch
Besen=broom (m) 
besser=better(adverb)
besserer=better
bester=best
besuchen=visit
beten=pray
betrachten=watch(verb)
beträchtlich=considerable
betrunken=drunk
Bett=bed (n) 
bewegen=move
Biene=bee (f) 
Bier=beer (n) 
Bild=picture (n) 
billig=cheap
Birne=pear (f) 
bis=till
bis=until
bis jetzt=up to now
Biscuit=biscuit (n) 
bitte=please
bitten=ask(beg)
bitter=bitter
blau=blue
blind=blind
Blume=flower (f) 
Blumenkohl=cauliflower (m) 
Bluse=blouse (f) 
Blut=blood (n) 
Boden=ground (m) 
Bohne=bean (f) 
Boot=boat (n) 
böse=evil
böse=nasty
brauchen=need
braun=brown
brechen=break
breit=large
Bremse=brake (f) 
brennen=burn
brennen=burn
Brief=letter (m) 
Briefmarke=stamp (f) 
Briefumschlag=envelope (m) 
Brille=glasses (f) 
bringen=bring
Brot=bread (n) 
Brücke=bridge (f) 
Bruder=brother (m) 
Brunnen=fountain (m) 
Brust=breast (f) 
Brust=chest (f) 
Buch=book (n) 
Buchhandlung=bookshop (f) 
Büro=office (n) 
Bürste=brush (f) 
Bus=bus (m) 
Butter=butter (f) 
Café=café (n) 
château=castle (m) 
Cousin=cousin (f) 
Dach=roof (n) 
damit=with that
danke=thank you
danken=thank
dann=then
darnach=after that
Datum=date (n) 
Daumen=thumb (m) 
Decke=blanket (f) 
Ihr=your (singular)
denken=think
der=the (m)
die=the (f)
das=the (n)
Dessert=dessert (n) 
deswegen=therefore
Dezember=December
dich=you
dir=you
dick=thick
die=the(plur.)
die meisten=most
dienen als=serve as
Dienstag=Tuesday (m) 
diese=these
dieser=this (m)
diese=this (f)
dieses=this (n)
dir=to you
direkt=directly
Distanz=distance(f)
Donner=thunder(m)
Donnerstag=Thursday(m)
doppelt=double
Dorf=village(n)
dort=there
draussen=outside
drei=three
dreissig=thirty
dreizehn=thirteen
drinnen=inside
Sie=you(sing., formal))
du=you (sing., familiar)
dunkel=dark
dunkelblau=dark blue
dünn=thin
durch=across, through
Durchschnitt=average (m) 
Durst=thirst (m) 
Ecke=corner (f) 
Ehefrau=wife f
Ehemann=husband (m) 
eher=fairly,rather
eher=rather
Ei=egg n
Eiche=oak (f) 
eigener=own (m)
eigene=own (f)
eigenes=own (n)
eigentlich=actually,indeed
ein=a (m+n)
ein anderer=another (n)
ein andere=another (f)
ein anderes=another (n)
einmal=once
ein=a, one (m)
eine=a, one (f)
einfach=simple
Eingang=entrance m
einige=some(objects)
einladen=invite
eintreten=enter
Eis=ice, ice cream n
Eiskrem=ice cream
Eisen=iron n
Eiskrem=ice cream
Elefant=elephant (m) 
elf=eleven
Ellbogen=elbow (m) 
Ende=end (n) 
endlich=at last
endlich=finally
eng=narrow
entdecken=discover
Ente=duck (f) 
entlang=alongside
entscheiden=decide
enttäuscht=disappointed
er=he
Erbe=pea (f) 
Erdbeere=strawberry (f) 
Erde=earth (f) 
erklären=explain
erlauben=permit
erreichen=reach,manage
erster=first (m)
erste=first (f)
erstes=first (n)
erwachen=awake
erwachsen=adult
erwägen=consider
erzählen=tell
es=it
Esel=donkey (m) 
essen=eat
Esszimmer=dining room (n) 
etwa=about(circa)
etwas=some(thing)
euer=your(plur., familiar)
Ihr=your(plur., formal)
Fabrik=factory f
Faden=thread m
fähig=able, capable
Fahrkarte=ticket f
Fahrrad=bicycle n
Fahrstuhl=elevator (m) m
Fall=case, instance m
fallen=fall
fallen lassen=drop
falsch=false
falsch=wrong
Familie=family f
fangen=catch
Farbe=color f
fast=almost
Februar=February m
Fehler=fault m
Fehler=mistake m
fein=fine
Feind=enemy m
Fenster=window n
Ferien=holiday (f)
fest=firm,solid
fett=fat
Feuer=fire n
finden=find
Finger=finger m
flach=flat (adj.)
Flasche=bottle f
Fleisch=meat n
Fliege=fly (insect) f
fliegen=fly
Flughafen=airport m
Flugzeug=airplane n
Fluss=river
folgen=follow
Form=form f
fortsetzen=continue
fragen=ask(question)
Frau=Mrs.
Frau=woman f
Fräulein=Miss
frei=free(not bound)
Freitag=Friday m
ausländisch=foreign
fremd=strange, foreign
seltsam=strange
Freund=friend (m)
Freundin=friend (f)
frisch=fresh
fröhlich=glad
froh=glad
früh=early
Frühling=spring (m) 
Frühstück=breakfast (n) 
Fuchs=fox (m) 
füllen=fill
fünf=five
fünfzehn=fifteen
fünfzig=fifty
für=for (on behalf of)
Gabel=fork (f) 
Gans=goose (f) 
ganz=whole
Garten=garden (m)
Gebäude=building (n) 
geben=give
gebrauchen=use
Geburtstag=birthday (m) 
Gedächtnis=memory (n) 
Gedanke=thought (m) 
Gefahr=danger (f) 
gefährlich=dangerous
gegen=against
Geschenk=present (n) 
gehen=go
gehen=walk(go)
Gehirn=brain (n)
gelb=yellow
Geld=money (n) 
Gemüse=vegetable (n) 
genug=enough
Gepäck=baggage (n) 
geradeaus=straight
gerne=gladly(pleasure)
Gerste=barley (f) 
Geschäft=business (n) 
Geschmack=taste(noun) (m) 
Gesellschaft=company (f) 
Gesicht=face (n) 
gestern=yesterday
gesund=healthy
Gesundheit=health (f) 
Getränk=beverage (n) 
Gewehr=gun (n) 
gewiss=certainly
gewöhnlich=ordinary
Glas=glass (n) 
glauben=believe
gleich=equal
gleich=similar
gleicher=same (m)
gleiche=same (f)
gleiches=same (n)
Glocke=bell (f) 
Glück=luck (n) 
glücklich=happy
Gold=gold (n) 
Gott=god
Grad=degree (m) 
Gras=grass (n) 
gratis=free(no cost)
grau=gray
gross=big
gross=tall
Grossmutter=grandmother (f) 
Grossvater=grandfather (m)
grün=green
Grund=cause (m) 
Grund=reason (m) 
gültig sein=be valid
Gurke=cucumber (f) 
Gurt=belt (m) 
gut=good
gut=well
Haare=hair (head) (f)
haben=have
halb=half
Hals=neck (m) 
Hals=throat (m)
halten=hold
halten=keep
Haltestelle=stop (f) 
Hammer=hammer (m) 
Hand=hand (f) 
Handtasche=handbag (f) 
hängen=hang
hard=hard
hassen=hate
hässlich=ugly
Haus=house (n) 
Haut=skin (f) 
heben=lift(weight)
heiss=hot
heissen=be called
helfen=help(verb)
Hemd=shirt (n) 
Herbst=autumn (m) 
Herr=Mr.
herum=around
Herz=heart (n) 
heute=today
heute morgen=this morning
hier=here
Hilfe=help(noun)
Himmel=sky (m)
hinter=behind
hoch=high
höchstens=at most
Hochzeit=marriage (f) 
holen=fetch
Holz=wood (n) 
hören=hear
hören=listen
zuhören=listen
Hose=trousers (f) 
Hotel=hotel, inn (n)
hübsch=pretty
Hühnchen=chicken (n)
Hund=dog (m) 
hundert=hundred
hungrig=hungry
Hut=hat (m) 
ich=I
ihn=him
sie=her
ihr=you(plur.)
ihre=their
im Ausland=abroad
immer=always
immer noch=still
in=in
in.....hinein=into
Insel=island (f) 
interessant=interesting
Interesse=interest
irgendwo=somewhere
ja=yes
Jacke=jacket (f) 
Jahr=year (n) 
Jahrhundert=century (n) 
Januar=January (m)
jeden=every (m)
jedene=every (f)
jedenes=every (n)
jemand=somebody
jener=that(object) (m)
jenere=that(object) (f)
jeneres=that(object) (n)
jetzt=now
Juli=July (m)
jung=young
Junge=boy (m)
Juni=June (m)
Kaffee=coffee (m) 
Kalb=calf (n) 
Kalbfleisch=veal (n) 
kalt=cold
Kamarad=comrade (m) 
Kamm=comb (m) 
Karte=card (f) 
Kartoffel=potato (f)
Käse=cheese (m) 
Kassierer=cashier (m) 
Kassiererin=cashier (f) 
Kathedrale=cathedral (f) 
Katze=cat
kaufen=buy
kaum=scarcely
Keller=basement (m) 
Keller=cellar (m) 
Kellner=waiter (m) 
kennen=know (person)
Kerze=candle (f) 
Kind=child (n) 
Kinn=chin (n) 
Kirche=church (f) 
Kirsche=cherry (f) 
klar=clear
hell=clear
Kleid=dress (n) 
Kleide=clothes (f)
klein=little,small
Klingel=bell (door) (f) 
Knie=knee (n) 
Knöchel=ankle (m)
Knochen=bone (m) 
Knopf=button (m) 
Koch=cook (m)
Köchin=cook (f)
kochen=cook (verb)
kochen=boil
sieden=boil
Kohl=cabbage (m)
kommen=come
König=king (m)
Königin=queen (f)
können=can
können=to know
Kopf=head (m)
Korb=basket (m)
Körper=body (m)
kosten=cost
Kragen=collar (m)
krank=sick, ill
Krankenschwester=nurse (f)
Krankheit=disease (f)
Kravatte=tie (f)
Krone=crown (f)
Küche=kitchen (f)
Kuchen=cake (m)
Kugelschreiber=pen (m)
Kuh=cow (f)
Kühlschrank=refrigerator (m)
Kunde=client (m)
Kunst=art (f)
Künstler=artist (m)
Künstlerin=artist (f)
Kuss=kiss (m)
lächeln=smile
lachen=laugh
Laden=store (m)
Lampe=lamp (f)
Land=country (n)
Land=land (n) 
Landkarte=map (f) 
Landstrasse=highway (f) 
Landstrasse=road (country) (f) 
lang=long(object)
lange=long(time)
langsam=slow
langweilg=boring
Lärm=noise (m) 
lassen=let, allow
Lastwagen=truck (m) 
laufen=run
rennen=run
laut=loud
läuten=ring
leben=live
Leben=life (f) 
leer=empty
legen=lay
legen=put, place
stellen=put, place
lehren=teach
Lehrer=teacher (m) 
Lehrerin=teacher (f) 
leicht=easy
leicht=light in weight
leise=low
Leiter=ladder (f) 
lernen=learn
lesen=read
letzter=last m
letztere=last f
letzteres=last (n)
Leute=people (f) (f) 
Licht=light (lamp)
Liebe=love (noun) (f)
lieben=love (verb)
liegen=lie
links=left (hand)
Lippe=lip (f) 
Loch=hole (n) 
Löffel=spoon (m) 
Luft=air (f) 
lügen=lie(tell lies)
Lust=inclination,fancy f
lustig=funny
machen=make, cause
Mädchen=girl (n) 
Magazin=magazine (n) 
Magen=stomach (m) 
Mahlzeit=meal (f) 
Mai=May (m)
mal=times(many)
man=one(impers.)
manchmal=sometimes
Mann=man(human) m
Mensch=man(human) m
Mantel=coat (m) 
Mantel=overcoat (m) 
Marmelade=jam (f) 
März=March (m) 
Maschine=machine (f) 
Maus=mouse (f) 
Meer=sea (n) 
Mehl=flour (n)
mehr=more
mehr...als=more... than
mein=my (m)
meine=my (f)
meinen=mean
denken=mean, think
Messer=knife (n) 
Metall=metal (n) 
Metzger=butcher (m) 
mich=me, myself
Milch=milk (f) 
Minute=minute (f) 
mir=me
mit=with
Mittag=midday, noon
Mittagessen=lunch (n) 
Mitternacht=midnight
mittlerer=middle (m)
mittleres=middle (f)
mittleres=middle (f)
Mittwoch=Wednesday (m) 
Möbel=furniture (f)
mögen=like(love)
möglich=possible
Moment=moment (m) 
Monat=month (m)
Mond=moon (m) 
Montag=Monday (m) 
morgen=tomorrow
Morgen=morning (m) 
Motor=engine (m) 
müde=tired
Mund=mouth (m) 
müssen=must
Mutter=mother (f) 
nach=after
nachdem=after
Nachbar=neighbor (m) 
nachher=afterwards
Nachmittag=afternoon (m)
Nachrichten=news (f)
nächster=next (m)
nächstere=next (f)
nächsteres=next (n)
Nacht=night (f) 
Nadel=needle (f) 
Nagel=nail (m) 
nahe=near, close
bei=near, close
Nahrung=food (n)
Essen=food (f)
Name=name (m)
Nase=nose (f)
nass=wet
Natur=nature (f) 
natürlich=of course
gewiss=of course
nehmen=take
nein=no
nett=nice
neu=new
neun=nine
neunzehn=nineteen
neunzig=ninety
nicht=not
nichts=nothing
nie=never
niemand=nobody
nirgendwo=nowhere
noch=yet
Norden=north
November=November (m) 
null=zero
nur=just(nur)
nur=only
Nuss=nut (f) 
obwohl=although
oder=or
Oel=oil (n) 
Ofen=oven
Ofen=stove (m)
öffnen=open
oft=often
ohne=without
Ohr=ear (n) 
Oktober=October (m) 
Onkel=uncle (m) 
Orange=orange (f) 
Ort=place, spot (m)
Stelle=place, spot (f)
Osten=east
Paar=couple (n) 
Papa=daddy
Papier=paper (n)
parkieren=parking
Party=party (f)
Pass=passport (m) 
passen=suit(verb)
passend=suitable
Person=person (f) 
Pferd=horse (n) 
pflücken=pick
Platz=square (m) 
plötzlich=suddenly
Post=mail (f) 
Postbüro=post office (n)
Postkarte=postcard (f)
prächtig=splendid
Preis=price (m)
prüfen=check
pünktlich=on time,in time
Rad=wheel (n) 
Radio=radio (n) 
Rat=advice (m) 
rauchen=smoke
Rechnung=bill (f) 
Recht=right, just claim (n)
rechts=right (not left)
reden=talk
Regen=rain (m)
regnen=rain (verb)
reich=rich
Reifen=tire (m) 
Reis=rice (m) 
Reise=trip (f) 
reisen=travel(verb)
reissen=tear (pull)
Restaurant=restaurant (n) 
richtig=correct
korrekt=correct
Richtung=direction (f) 
riechen=smell
Rindfleisch=beef (n) 
Rock=skirt (m)
rot=red
Rübe=carrot (f)
Karrotte=carrot (f)
Rücken=back (m) 
rufen=call
anrufen=call
ruhig=quiet
rühren=stir
rund=round
Sache=thing (f)
Ding=thing (n)
Saft=juice (m)
sagen=say
Sahne=cream (f)
Salat=salad (m) 
Salz=salt (n) 
Samstag=Saturday (m) 
sauber=clean
sauer=sour
Schachtel=box (f) 
Sache, f, thing
Ding=thing (n) 
Saft=juice (m) 
sagen=say
Sahne=cream (f) 
Salat=salad (m) 
Salz=salt (n)
Samstag=Saturday (m) 
sauber=clean
sauer=sour
Schachtel=box (f) 
Schale=bowl (f) 
Schatten=shadow (m) 
schauen=look
Schauspieler=actor (m) 
Schauspielin=actress (f) 
scheinen=seem
Schere=scissors (f) 
schiessen=shoot
Schiff=ship (n)
Schinken=ham (m) 
Schirm=umbrella (m) 
schlafen=sleep
Schlafzimmer=bedroom (n) 
schlagen=hit, strike
Schlange=snake (f) 
schlecht=badly
schlechter=bad (m)
schlechte=bad (f)
schlechtes=bad (n)
schlimm=nasty
Schlüssel=key (m) 
Schmetterling=butterfly (m)
schmutzig=dirty
Schnecke=snail (f) 
Schnee=snow (m) 
schneiden=cut
schnell=fast,quick, quckly
Schokolade=chocolate (f)
schon=already
schön=beautiful
Schrank=cupboard (m) 
Schraube=screw (f) 
schreiben=write
Schriftsteller=author (m) 
Schriftstellerin=author (f) 
Schublade=drawer (f) 
Schuhe=shoes (f)
Schule=school (f) 
Schulter=shoulder (f) 
schwarz=black
Schwein=pig (n) 
Schweinefleisch=pork (n) 
schwer=heavy
Schwester=sister (f) 
schwierig=difficult
Schwierigkeiten=trouble
schwimmen=swim
sechs=six
sechzehn=sixteen
sechzig=sixty
See=lake (m) 
sehen=see
sehr=very
Seife=soap (f) 
Seil=cord (n) 
sein=be
sein=his
seit=since
Seite=page (f)
selten=rare
selten=seldom
senden=send
schicken=send
September=September (m) 
Serviette=napkin (f) 
Sessel=armchair (m) 
sich=oneself
sich ausruhen=rest
sich beeilen=hurry
sich erinnern=remember
sich fragen=wonder(verb)
sich fühlen=feel (good)
sich rasieren=shave
sich setzen=sit
sicher=sure
sie=she, they
sieben=seven
siebzehn=seventeen
siebzig=seventy
Silber=silver (n) 
singen=sing
so=so
so=thus
darum=thus
sofort=immediately
sogar=even(when)
Sohn=son (m) 
solcher=such (m)
solchere=such (f)
solchres=such (n)
Sommer=summer (m) 
Sonne=sun (f) 
Sonntag=Sunday (m) 
sonst=otherwise
spät=late
Speck=bacon (m) 
Spiegel=mirror (m) 
spielen=play
Spital=hospital (n) 
Sprache=language
sprechen=speak
springen=jump
Stadt=city (f) 
Stadt=town (f) 
Stahl=steel (m) 
stark=strong
Staubsauger=vacuum cleaner (m)
Steak=beefsteak (n) 
stehen=stand
Stein=stone (m) 
sterben=die
Stern=star (m) 
stossen=push
Stpckwerk=floor (n) 
Strand=beach (m) 
Strasse=street (city)
Stück=piece (n) 
Student=student (m)
Studentin=student (f) 
studieren=study
Stuhl=chair (m) 
Stunde=hour (f) 
Sturm=storm (m) 
Süden=south
Sünde=sin (f) 
Suppe=soup (f) 
süss=sweet
Tag=day (m) 
Tante=aunt (f) 
tanzen=dance
Tasche=bag (f) 
Taschentuch=handkerchief (n) 
Tasse=cup (f) 
taub=deaf
tausend=thousand
Tee=tea (m) 
Teil=part (of whole)
teilweise=partly
Telefon=telephone (n) 
Teller=plate (m) 
Teppich=carpet (m) 
teuer=expensive, dear
lieb=dear
tief=deep
Tier=animal (n)
Tiger=tiger (m)
Tisch=table (f)
Tochter=daughter (f)
Toilette=toilet (f)
Tomate=tomato (f)
Topf=pot (m)
tot=dead
tragen=carry, wear (clothes)
Träne=tear(eye) (f)
Traum=dream (m)
traurig=sad
treffen=meet
Treppe=stairs (f)
trinken=drink
trocken=dry
trotz=in spite of
tun=to do
machen=to make
Türe=door (f)
Turm=tower (m)
U-Bahn=underground
über=over, above
darüber=above
überall=everywhere
übersetzen=translate
übrigens=by the way
Uhr=clock(tower), watch (f)
um=at(time)
und=and
und so weiter=and so on
Unfall=accident (m)
uns=us
unser=our (m)
unsere=our (f)
unten=down
hinunter=down
unter=under, below
darunter=below
zwischen=among
unterdessen=meanwhile
usw.=and so on(abbr)
Vater=father (m)
Verbindung=connection (f)
verboten=forbidden
Verbrechen=crime (n)
verbrennen=burn
verdienen=earn
Vergangenheit=past (f)
vergeben=forgive
vergessen=forget
vergleichen=compare
vergnügen=amuse
verheiratet=married
verkaufen=sell
verlangen=demand
verletzen=hurt, injure
verlieren=lose
vermeiden=avoid
verschieden=different
versprechen=promise
verstehen=understand
Versuch=attempt (m) 
versuchen=try
Vieh=cattle (n) 
viel=much
viele=many
vielleicht=perhaps
vier=four
vierzehn=fourteen
vierzig=forty
Vogel=bird (m) 
voll=full
von=from
von=of
vor=ago
vor=before
vor=in front of
Vorhang=curtain (m) 
Vorschlag=proposal
vorsichtig=careful
wachsen=grow
Wagen=car (m) 
Auto=car (n) 
wählen=choose
auswählen=choose
wahr=true
während=during
während=while
wahrscheinlich=probably
Wald=forest (m) 
wandern=walk(wander)
Wange=cheek (f) 
wann=when
warm=warm
warten=wait
warum=why
was=what
waschen=wash
Wasser=water (n) 
Wechsel=change,exchange
wechseln=change,ex-
Wecker=alarm clock (m)
weder...noch=neither...nor
weg=off, away(gone)
Weg=way (m) 
weggehen=leave
weich=soft, not hard
weich=smooth
glatt=smooth
Weihnachten=Christmas
weil=because
Wein=wine (m) 
weinen=cry, weep
weiss=white
weit=far
welchen=whom(rel.)
welcher=who, that (which)  (m)
welchere=who, that (which) (f)
welcheres=who, that (which) (n)
Welt=world (f) 
wenig=few
wenig=little(amount)
wenigstens=at least
wenn=if
wer=who
werden=get(become)
werfen=throw
Westen=west
Wette=bet (f) 
Wetter=weather (n) 
wichtig=important
wie=as(what)
wie=how
wie=like(as)
wiedeerholen=repeat
wieder=again
Wiese=meadow (f) 
Wind=wind (m) 
Winter=winter (m) 
wir=we
wirklich=really
Wissenschaft=science (f) 
wo=where
Woche=week (f) 
wohnen=dwel,live
wohnen=live, dwell
Wohnung=apartment, flat (f)
Wolke=cloud (f) 
Wolle=wool (f) 
wollen=want
Wort=word (n) 
Wörterbuch=dictionary (n) 
Wünsche=greetings (f)
wünschen=wish(luck)
Wurst=sausage (f) 
Wüste=desert (f) 
wütend=angry
Zahl=number (f) 
zahlen=pay
zählen=count
berechnen=count
Zahn=tooth (m) 
Zahnarzt=dentist (m) 
Zahnbürste=toothbrush (f) 
Zange=tongs (f) 
Zehe=toe (f) 
zehn=ten
zeichnen=draw, sketch
zeigen=show
Zeit=time (f) 
Zeitung=newspaper (f) 
Zentrum=center (n) 
ziehen=pull
Ziel=aim (n) 
Zigarette=cigarette (f)
Zimmer=room (n)
Zitrone=lemon (f)
Zoll=customs
zu=to
Zucker=sugar
zufällig=by chance
zufrieden=satisfied
Zug=train
zuhause=home, at home
Zukunft=future
Zunge=tongue
zurück=back
zurückkommen=come back
zusammen=together
zustimmen=agree
zwanzig=twenty
zwei=two
zweimal=twice



